#############
## ### ######
# M # M   #X#
# MM# M # # #
# #  R###   #
#  ###   ####
#     M     #
#############