#########################
# M            #        #
#    ## ###### # ## # #D#
# M #       P# # ## # # #
## ########### # # M  # #
#           #  # ##P# #X#
### # ##### # ## ##M#####
#        M  # #    M    #
# # #### #### ####### # #
#    B#   MR#           #
#########################