#########################
## ### ######    M #    #
# M # M   #P# ## # #   ##
# MM# M # # # ## # #  #B#
# #  R###   #    # # #  #
#  ###   #### ## # ###  #
#     M     # # M       #
########### # #         #
#     #   M # #  # ####D#
#P##  M  MM   #M # #X   #
#########################