#########################
#     #        #        #
#    #  ###### # ## # #D#
#   #        # # ## # # #
## ########### # # M  # #
#           #  # ##P# #X#
### # ##### # ## ##M#####
#        M  # #    M    #
# # #### #### ####### # #
#    B#   MR#           #
#########################