#########################
#X  #P##     M      P##X#
#R# # #### #   ######## #
# # # M  # ####     #   #
#  M  # ##      ##M # # #
# # ### ## ###### MM# # #
# ##P    # #######M # # #
#  #####   ###P ## ## # #
# M M P# #### MM##    M #
##    ##        ## ## #P#
#########################